12	12										
3	2	2	2	2	2	2	2	2	2	2	9
4	100	100	100	100	100	100	100	100	100	100	8
4	100	100	100	100	100	100	100	100	100	100	8
4	100	100	100	100	100	100	100	100	100	100	8
4	100	100	100	100	100	100	100	100	100	100	8
4	100	100	100	100	100	100	100	100	100	100	8
12	100	100	100	100	100	100	100	100	100	100	8
100	100	100	100	100	100	100	100	100	100	100	8
100	100	100	100	100	100	100	100	100	100	100	8
13	100	100	100	100	100	100	100	100	100	100	8
4	100	100	100	100	100	100	100	100	100	100	8
5	6	6	6	6	6	6	6	6	6	6	7
