8	8						
3	12	18	18	11	2	2	9
4	100	100	100	100	100	100	8
4	100	100	100	100	100	100	11
4	100	100	100	100	100	100	100
4	100	100	100	100	100	100	100
4	100	100	100	100	100	100	10
4	100	100	100	100	100	100	8
5	6	6	13	100	100	10	7
