13;11
3;2;2;2;2;2;2;2;2;9;0;0;0
4;1;1;1;1;1;1;1;1;8;0;0;0
4;1;1;1;1;1;1;1;1;8;0;0;0
4;1;1;1;1;1;1;1;1;5;2;2;9
4;1;1;1;1;1;1;1;1;1;1;1;8
4;1;1;1;1;1;1;1;1;1;1;1;8
4;1;1;1;3;6;9;1;1;1;1;1;8
4;1;1;1;8;0;4;1;1;1;1;1;8
4;1;1;1;5;2;7;1;1;1;1;1;8
4;1;1;1;1;1;1;1;1;1;1;1;8
5;6;6;6;6;6;6;6;6;6;6;6;7