8;8
3;2;2;2;2;2;2;9
4;1;1;1;1;1;1;8
4;1;1;1;1;1;1;8
4;1;1;1;1;1;1;8
4;1;1;1;1;1;1;8
4;1;1;1;1;1;1;8
4;1;1;1;1;1;1;8
5;6;6;6;6;6;6;7