9	12							
14	14	14	14	2	2	2	2	9
30	30	30	30	54	100	100	100	8
32	32	32	32	55	100	100	100	8
32	32	32	32	55	100	100	100	8
31	31	31	31	53	100	100	100	8
16	16	16	16	13	100	100	100	8
14	14	14	14	12	100	100	100	8
51	51	51	51	54	100	100	100	8
52	52	52	52	55	100	100	100	8
52	52	52	52	55	100	100	100	8
50	50	50	50	53	100	100	100	8
16	16	16	16	6	6	6	6	7
